.......###################....##########
.Y.....................................#
..................=====................#
.......................................#
.....====..........=====...............#
.......................................#
...............=========...............#
.......................................#
.........................=======.......#
.......................................#
............................====.......#
........................................
...........................====.........
.....................====...............
..................====..................
...........=====.......................#
.......................................#
.____________________________..________#