########################################
#Y.....................................#
#......................................#
#......................................#
#....====..............................#
#......................................#
#..............====....................#
#......................................#
#........................====..........#
#......................................#
#......................................#
#......................................#
#......................................#
#......................................#
#......................................#
#......................................#
#......................................#
########################################