.......###################....##########
.Y.....................................#
.......................................#
.......................................#
.....====..............................#
.......................................#
...............====....................#
.......................................#
.........................====..........#
.......................................#
.......................................#
........................................
...........................====.........
.....................====...............
..................====..................
...........=====.......................#
.......................................#
.____________________________..________#